........................
........................
..BBBBBBBB....BBBBBBBB..
........................
........................
........................
........................
........................
........................
......S.BBBBBBBB.S......
........................
........................
........................
........................
......S.BBBBBBBB.S.......
........................
........................
........................
........................
........................
........................
..BBBBBBBB....BBBBBBBB..
........................
........................