........................
........................
........XXXXXXXX........
.......X........X.......
.......X...SS...X.......
.......X........X.......
.......X........X.......
.......X........X.......
.......X........X.......
.......X........X.......
.......X........X.......
........................
........................
.......X........X.......
.......X........X.......
.......X........X.......
.......X........X.......
.......X........X.......
.......X........X.......
.......X...SS...X.......
.......X........X.......
........XXXXXXXX........
........................
........................