........................
........................
........................
...M.M.M.M....M.M.M.M...
....M.M.M......M.M.M....
...M.M.M.M....M.M.M.M...
....M.M.M......M.M.M....
...M.M.M.M....M.M.M.M...
....M.M.M......M.M.M....
...M.M.M.M....M.M.M.M...
........................
......S..........S......
......S..........S......
........................
...M.M.M.M....M.M.M.M...
....M.M.M......M.M.M....
...M.M.M.M....M.M.M.M...
....M.M.M......M.M.M....
...M.M.M.M....M.M.M.M...
....M.M.M......M.M.M....
...M.M.M.M....M.M.M.M...
........................
........................
........................