........................
........................
..BBBBBBBB....BBBBBBBB..
........................
........................
........................
........................
........................
........................
........BBBBBBBB........
........................
........................
........................
........................
........BBBBBBBB........
........................
........................
........................
........................
........................
........................
..BBBBBBBB....BBBBBBBB..
........................
........................