........................
........................
........................
........................
....S..............S....
........................
........................
........MMMMMMMM........
........M......M........
........M......M........
........M......M........
........M......M........
........M......M........
........M......M........
........MMMMMMMM........
........................
........................
........................
........................
....S..............S....
........................
........................
........................
........................