........................
........................
.....PPPPPPPPPPPPPP.....
........................
........................
..P..................P..
..~..................~..
..~..................~..
..~..................~..
..~..................~..
..~..................~..
..~..................~..
..~..................~..
..~..................~..
..~..................~..
..~..................~..
..~..................~..
..~..................~..
..~..................~..
........................
........................
.....PPPPPPPPPPPPPP.....
........................
........................