........................
........................
........................
........................
..........MMMM..........
........................
........................
........................
........................
..........MMMM..........
....M....M....M....M....
....M....M....M....M....
....M....M....M....M....
....M....M....M....M....
..........MMMM..........
........................
........................
........................
........................
..........MMMM..........
........................
........................
........................
........................