.......................
.......................
...MMMMM........MMMMM..
...MMMMM........MMMMM..
...MMBMM........MMBMM..
...MMMMM........MMMMM..
...MMMMM........MMMMM..
.......................
.......................
.......................
.......................
.......................
.......................
.......................
.......................
.......................
.......................
...MMMMM........MMMMM..
...MMMMM........MMMMM..
...MMBMM........MMBMM..
...MMMMM........MMMMM..
...MMMMM........MMMMM..
.......................
.......................